^^^^^^^^^^^^^^^^^^^^^^^^^^^^^^^^^^^^^^^^^^^^^^^^^^
^^^^^^^^^^^^^^^^^^^^^^^^^^^^^^^^^^^^^^^^^^^^^^^^^^
^^^^^^^^^^^^^^^^^^^^^^^^^^^^^^^^^^^^^^^^^^^^^^^^^^
^^^^^^^^^^^^^^^^^^^^^^^^^^^^^^^^^^^^^^^^^^^^^^^^^^
^^^^^^^^^^^^^^&&&&&^^^^V^^^^^^^^^^^^^^^^^^^^^^^^^^
^^^^^^^^^^^V&&&&&&&&&&&&&^^V^^^^^^^^^^^^^^^^^^^^^^
^^^^^^^^^^^&&&VPV&&&&&&&&&&^^V^^^^^^^V^^^^^^^^^^^^
^^^^^~^^^^^&&&P P&&&&&&&&&&&&&^^^^V.&&&V^^^^^^^^^^
^^^^~~~~^^^^&&VPV&&&&&&&&&~~~&&^^&&&&&&^^^^^^^^^^^
^^^^~~~~^^^V&&&&&&&&&&&&&&~Q=...&&&&&<.+ ^^^^^^^^^
^^^^~~~~^^^^^&&&&&&&&&&&&&~~~&&.&&&&&&&^^^^^^^^^^^
^^^^~~~~~^^^^V&&,&&&&&&&&&&&&&&.&&&&&&V^^^^^^^^^^^
^^^~~^^^~~~^^^^,,&&&&&&&&&&&&&&.&&&&&^^^^^^^^^^^^^
^^^~^^^^^^~^^,,,,,&&####&&&&&&&.&&&&V^^^^^^^^^^^^^
^^^^^^^^^^~~~,,,,,,,#h.#&&&&&&&.&&^^^^^^^^^^^^^^^^
^^^^^^^^^^^^~~~,,,,,#1.#&&&&&&&.&^^^^^^^^^^^^^^^^^
^^^^^^^^^^VV^~~~~~..#x##,,,,,&&.#######^^^^^^^^^^^
^^^^^^^^^^^^,,,,.=,...,,,,,,,,,.x.4..*#^^^^^^^^^^^
^^^^^^^^^^^^,,,,.~~,,,,,,,,,,,,,#....h#^^^^^^^^^^^
^^^^^^^^^######,.,~~~,,,,,,~~~~~##x####^^^^^^^^^^^
^^^^^^^^^#h...#,.,,,~~~,,,~~,,,~,,.,,,V^^^^^^^^^^^
^^^^^^^^^#O...x..,,,,,~~~~~,,..=...,,,^V^^^^^^^^^^
^^^^^^^^^#h..2#,.,,,,,~,,,,,,.,~,,,,,,^^^V^^^^^^^^
^^^^^^^^^######,.,,,,,~,,,,,,.,~~~~~~~~~~~~~~~~~^^
^^^^^^^^^^,,,,,,......=.......,,,,,,,,,,V^^^^^^^^^
^^^^^^^^ +,,,,...,,,,,~,,.,,,,,,,,,,,,,,,^^^^^^^^^
^^^^^^^^^^,,,,.,,,,,,~~,,.,,,,,,,,""""",,^^^^^^^^^
^^^^^^^^^V,###x##,,,~~,,,.,,,,,,,,""5"",,^^^^^^^^^
^^^^^^^^^^,#....#,,~~,,,,.,,,,,,,,""""",,^^^^^^^^^
^^^^^^^^^^,#h...#,,~,,,,,........."""""^V^^V^^^^^^
^^^^^^^^^V,#Oh.3#,~~,,,,,.,,,.,,,."""5"^^^^^^^^^^^
^^^^^^^^^^^######,~,,,"""",,"""5,."""""^^V^^^^^^^^
^^^^^^^^^^^^,,,,,,~,,,"5"",,"""",.,,,,^V^^^^^VVV^^
^^^^^^^^^^^^V^,,,~~,,,"""",,"""",...,^V^^^^^;;;W^^
^^^^^^^^^^^^^^^^V~,,,,"""",,""5",,,.,^^^^^;;;^VV^^
^^^^^^^^^^^^^^^^^~^,,,"""",,"""",^,.,^^;;;;V^^^^^^
^^^^^^^^^^^^^^^^^~VV^,"5"",,""""^^^^,;;;^^^^^^^^^^
^^^^^^^^^^^^^^^^^~^^^^^,,,,,,,,^^^V^^^,^^^^^^^^^^^
^^^^^^^^^^^^^^^^~^^^^^^^^,,,,,^^^^^^^V^^^^^^^^^^^^
^^^^^^^^^^^^^^^V~^^^^^^^^^^^^^^^^^^^^^^^^^^^^^^^^^
^^^^^^^^^^^^^^^^~^^^^^^^^^^^^^^^^^^^^^^^^^^^^^^^^^
^^^^^^^^^^^^^^^^~^^^^^^^^^^^^^^^^^^^^^^^^^^^^^^^^^
^^^^^^^^^^^^^^^~~^^^^^^^^^^^^^^^^^^^^^^^^^^^^^^^^^
^^^^^^^^^^^^^^~~^^^^^^^^^^^^^^^^^^^^^^^^^^^^^^^^^^
^^^^^^^^^^^^^~~^^^^^^^^^^^^^^^^^^^^^^^^^^^^^^^^^^^
^^^^^^^^^^^~~~~^^^^^^^^^^^^^^^^^^^^^^^^^^^^^^^^^^^
^^^^^^^^^^^~~~~^^^^^^^^^^^^^^^^^^^^^^^^^^^^^^^^^^^
^^^^^^^^^^^~~~^^^^^^^^^^^^^^^^^^^^^^^^^^^^^^^^^^^^
^^^^^^^^^^^^^^^^^^^^^^^^^^^^^^^^^^^^^^^^^^^^^^^^^^
^^^^^^^^^^^^^^^^^^^^^^^^^^^^^^^^^^^^^^^^^^^^^^^^^^
